11111
100E1
10C01
1P001
10001
11111