111111111
10C0000E1
100111111
10C000001
100111111
10C000001
1P0000001
111111111
111111111
10C0000E1
100111111
10C000001
100111111
10C000001
1P0000001
111111111