11111111111111111
10000000000000E01
10000000000000001
1111111WW11111111
10000000000000001
10C11111111111111
10000000000000001
100000000C0000001
11111111111111001
10000000000000001
10P00000C00000001
11111111111111111