11111111111111111
1000000000000E001
10000000000000001
11111110011111111
100000C0011111111
11100111111111111
10000000000000001
1000C000000000001
10000000C00000P01
11111111111111111