111111111
100000E01
1P0000001
111111111