11111111101
10000000E01
10000C00001
10P00000001
11111111111